Available Tokenizers:
keyword	org.apache.lucene.analysis.core.KeywordTokenizerFactory
letter	org.apache.lucene.analysis.core.LetterTokenizerFactory
whitespace	org.apache.lucene.analysis.core.WhitespaceTokenizerFactory
edgeNGram	org.apache.lucene.analysis.ngram.EdgeNGramTokenizerFactory
nGram	org.apache.lucene.analysis.ngram.NGramTokenizerFactory
pathHierarchy	org.apache.lucene.analysis.path.PathHierarchyTokenizerFactory
pattern	org.apache.lucene.analysis.pattern.PatternTokenizerFactory
simplePatternSplit	org.apache.lucene.analysis.pattern.SimplePatternSplitTokenizerFactory
simplePattern	org.apache.lucene.analysis.pattern.SimplePatternTokenizerFactory
classic	org.apache.lucene.analysis.standard.ClassicTokenizerFactory
standard	org.apache.lucene.analysis.standard.StandardTokenizerFactory
uax29UrlEmail	org.apache.lucene.analysis.standard.UAX29URLEmailTokenizerFactory
thai	org.apache.lucene.analysis.th.ThaiTokenizerFactory
wikipedia	org.apache.lucene.analysis.wikipedia.WikipediaTokenizerFactory


Available Char Filters:
htmlStrip	org.apache.lucene.analysis.charfilter.HTMLStripCharFilterFactory
mapping	org.apache.lucene.analysis.charfilter.MappingCharFilterFactory
cjkWidth	org.apache.lucene.analysis.cjk.CJKWidthCharFilterFactory
persian	org.apache.lucene.analysis.fa.PersianCharFilterFactory
patternReplace	org.apache.lucene.analysis.pattern.PatternReplaceCharFilterFactory


Available Token Filters:
apostrophe	org.apache.lucene.analysis.tr.ApostropheFilterFactory
arabicNormalization	org.apache.lucene.analysis.ar.ArabicNormalizationFilterFactory
arabicStem	org.apache.lucene.analysis.ar.ArabicStemFilterFactory
bulgarianStem	org.apache.lucene.analysis.bg.BulgarianStemFilterFactory
delimitedBoost	org.apache.lucene.analysis.boost.DelimitedBoostTokenFilterFactory
bengaliNormalization	org.apache.lucene.analysis.bn.BengaliNormalizationFilterFactory
bengaliStem	org.apache.lucene.analysis.bn.BengaliStemFilterFactory
brazilianStem	org.apache.lucene.analysis.br.BrazilianStemFilterFactory
cjkBigram	org.apache.lucene.analysis.cjk.CJKBigramFilterFactory
cjkWidth	org.apache.lucene.analysis.cjk.CJKWidthFilterFactory
soraniNormalization	org.apache.lucene.analysis.ckb.SoraniNormalizationFilterFactory
soraniStem	org.apache.lucene.analysis.ckb.SoraniStemFilterFactory
commonGrams	org.apache.lucene.analysis.commongrams.CommonGramsFilterFactory
commonGramsQuery	org.apache.lucene.analysis.commongrams.CommonGramsQueryFilterFactory
dictionaryCompoundWord	org.apache.lucene.analysis.compound.DictionaryCompoundWordTokenFilterFactory
hyphenationCompoundWord	org.apache.lucene.analysis.compound.HyphenationCompoundWordTokenFilterFactory
decimalDigit	org.apache.lucene.analysis.core.DecimalDigitFilterFactory
lowercase	org.apache.lucene.analysis.core.LowerCaseFilterFactory
stop	org.apache.lucene.analysis.core.StopFilterFactory
type	org.apache.lucene.analysis.core.TypeTokenFilterFactory
uppercase	org.apache.lucene.analysis.core.UpperCaseFilterFactory
czechStem	org.apache.lucene.analysis.cz.CzechStemFilterFactory
germanLightStem	org.apache.lucene.analysis.de.GermanLightStemFilterFactory
germanMinimalStem	org.apache.lucene.analysis.de.GermanMinimalStemFilterFactory
germanNormalization	org.apache.lucene.analysis.de.GermanNormalizationFilterFactory
germanStem	org.apache.lucene.analysis.de.GermanStemFilterFactory
greekLowercase	org.apache.lucene.analysis.el.GreekLowerCaseFilterFactory
greekStem	org.apache.lucene.analysis.el.GreekStemFilterFactory
englishMinimalStem	org.apache.lucene.analysis.en.EnglishMinimalStemFilterFactory
englishPossessive	org.apache.lucene.analysis.en.EnglishPossessiveFilterFactory
kStem	org.apache.lucene.analysis.en.KStemFilterFactory
porterStem	org.apache.lucene.analysis.en.PorterStemFilterFactory
spanishLightStem	org.apache.lucene.analysis.es.SpanishLightStemFilterFactory
spanishMinimalStem	org.apache.lucene.analysis.es.SpanishMinimalStemFilterFactory
persianNormalization	org.apache.lucene.analysis.fa.PersianNormalizationFilterFactory
finnishLightStem	org.apache.lucene.analysis.fi.FinnishLightStemFilterFactory
frenchLightStem	org.apache.lucene.analysis.fr.FrenchLightStemFilterFactory
frenchMinimalStem	org.apache.lucene.analysis.fr.FrenchMinimalStemFilterFactory
irishLowercase	org.apache.lucene.analysis.ga.IrishLowerCaseFilterFactory
galicianMinimalStem	org.apache.lucene.analysis.gl.GalicianMinimalStemFilterFactory
galicianStem	org.apache.lucene.analysis.gl.GalicianStemFilterFactory
hindiNormalization	org.apache.lucene.analysis.hi.HindiNormalizationFilterFactory
hindiStem	org.apache.lucene.analysis.hi.HindiStemFilterFactory
hungarianLightStem	org.apache.lucene.analysis.hu.HungarianLightStemFilterFactory
hunspellStem	org.apache.lucene.analysis.hunspell.HunspellStemFilterFactory
indonesianStem	org.apache.lucene.analysis.id.IndonesianStemFilterFactory
indicNormalization	org.apache.lucene.analysis.in.IndicNormalizationFilterFactory
italianLightStem	org.apache.lucene.analysis.it.ItalianLightStemFilterFactory
latvianStem	org.apache.lucene.analysis.lv.LatvianStemFilterFactory
minHash	org.apache.lucene.analysis.minhash.MinHashFilterFactory
asciiFolding	org.apache.lucene.analysis.miscellaneous.ASCIIFoldingFilterFactory
capitalization	org.apache.lucene.analysis.miscellaneous.CapitalizationFilterFactory
codepointCount	org.apache.lucene.analysis.miscellaneous.CodepointCountFilterFactory
concatenateGraph	org.apache.lucene.analysis.miscellaneous.ConcatenateGraphFilterFactory
dateRecognizer	org.apache.lucene.analysis.miscellaneous.DateRecognizerFilterFactory
delimitedTermFrequency	org.apache.lucene.analysis.miscellaneous.DelimitedTermFrequencyTokenFilterFactory
dropIfFlagged	org.apache.lucene.analysis.miscellaneous.DropIfFlaggedFilterFactory
fingerprint	org.apache.lucene.analysis.miscellaneous.FingerprintFilterFactory
fixBrokenOffsets	org.apache.lucene.analysis.miscellaneous.FixBrokenOffsetsFilterFactory
hyphenatedWords	org.apache.lucene.analysis.miscellaneous.HyphenatedWordsFilterFactory
keepWord	org.apache.lucene.analysis.miscellaneous.KeepWordFilterFactory
keywordMarker	org.apache.lucene.analysis.miscellaneous.KeywordMarkerFilterFactory
keywordRepeat	org.apache.lucene.analysis.miscellaneous.KeywordRepeatFilterFactory
length	org.apache.lucene.analysis.miscellaneous.LengthFilterFactory
limitTokenCount	org.apache.lucene.analysis.miscellaneous.LimitTokenCountFilterFactory
limitTokenOffset	org.apache.lucene.analysis.miscellaneous.LimitTokenOffsetFilterFactory
limitTokenPosition	org.apache.lucene.analysis.miscellaneous.LimitTokenPositionFilterFactory
removeDuplicates	org.apache.lucene.analysis.miscellaneous.RemoveDuplicatesTokenFilterFactory
stemmerOverride	org.apache.lucene.analysis.miscellaneous.StemmerOverrideFilterFactory
protectedTerm	org.apache.lucene.analysis.miscellaneous.ProtectedTermFilterFactory
trim	org.apache.lucene.analysis.miscellaneous.TrimFilterFactory
truncate	org.apache.lucene.analysis.miscellaneous.TruncateTokenFilterFactory
typeAsSynonym	org.apache.lucene.analysis.miscellaneous.TypeAsSynonymFilterFactory
wordDelimiter	org.apache.lucene.analysis.miscellaneous.WordDelimiterFilterFactory
wordDelimiterGraph	org.apache.lucene.analysis.miscellaneous.WordDelimiterGraphFilterFactory
scandinavianFolding	org.apache.lucene.analysis.miscellaneous.ScandinavianFoldingFilterFactory
scandinavianNormalization	org.apache.lucene.analysis.miscellaneous.ScandinavianNormalizationFilterFactory
edgeNGram	org.apache.lucene.analysis.ngram.EdgeNGramFilterFactory
nGram	org.apache.lucene.analysis.ngram.NGramFilterFactory
norwegianLightStem	org.apache.lucene.analysis.no.NorwegianLightStemFilterFactory
norwegianMinimalStem	org.apache.lucene.analysis.no.NorwegianMinimalStemFilterFactory
patternReplace	org.apache.lucene.analysis.pattern.PatternReplaceFilterFactory
patternCaptureGroup	org.apache.lucene.analysis.pattern.PatternCaptureGroupFilterFactory
patternTyping	org.apache.lucene.analysis.pattern.PatternTypingFilterFactory
delimitedPayload	org.apache.lucene.analysis.payloads.DelimitedPayloadTokenFilterFactory
numericPayload	org.apache.lucene.analysis.payloads.NumericPayloadTokenFilterFactory
tokenOffsetPayload	org.apache.lucene.analysis.payloads.TokenOffsetPayloadTokenFilterFactory
typeAsPayload	org.apache.lucene.analysis.payloads.TypeAsPayloadTokenFilterFactory
portugueseLightStem	org.apache.lucene.analysis.pt.PortugueseLightStemFilterFactory
portugueseMinimalStem	org.apache.lucene.analysis.pt.PortugueseMinimalStemFilterFactory
portugueseStem	org.apache.lucene.analysis.pt.PortugueseStemFilterFactory
reverseString	org.apache.lucene.analysis.reverse.ReverseStringFilterFactory
russianLightStem	org.apache.lucene.analysis.ru.RussianLightStemFilterFactory
shingle	org.apache.lucene.analysis.shingle.ShingleFilterFactory
fixedShingle	org.apache.lucene.analysis.shingle.FixedShingleFilterFactory
snowballPorter	org.apache.lucene.analysis.snowball.SnowballPorterFilterFactory
serbianNormalization	org.apache.lucene.analysis.sr.SerbianNormalizationFilterFactory
classic	org.apache.lucene.analysis.standard.ClassicFilterFactory
swedishLightStem	org.apache.lucene.analysis.sv.SwedishLightStemFilterFactory
synonym	org.apache.lucene.analysis.synonym.SynonymFilterFactory
synonymGraph	org.apache.lucene.analysis.synonym.SynonymGraphFilterFactory
flattenGraph	org.apache.lucene.analysis.core.FlattenGraphFilterFactory
teluguNormalization	org.apache.lucene.analysis.te.TeluguNormalizationFilterFactory
teluguStem	org.apache.lucene.analysis.te.TeluguStemFilterFactory
turkishLowercase	org.apache.lucene.analysis.tr.TurkishLowerCaseFilterFactory
elision	org.apache.lucene.analysis.util.ElisionFilterFactory
